NO textures/north.png
SO textures/south.png
WE textures/west.png
EA textures/east.png

F 82,51,43
C 82,95,229

        1111111111111111111111111
        1000000000000000000000001
        1011000000000000000000001
1       1001000000000000000W00001
111111111011000000110000000000001
100000000011000000000000000011111
11110111111111000000000010001
11110111111111011100010010001
11000000110101011100000010001
10000000000000001100000010001
10000000000000001101010010001
1100000111010101111101111000111
11110111 1110101 101111010001
11111111 1111111 111111111111
